                    +----+                                                                            
                    |....|                                                                            
                +---+....+--+                                                                         
                |...........|                                                                         
                +------#----+                                                                         
         +-------------#----------+                                                                   
         |........................|                                                                   
         |........................|                                                                   
         +--+.+---+...............|                                                                   
         |  |.|   |...............|                                                                   
         |  +-+   |...............|                      ###                                          
+--------+--------+...............|        ############### #####                                      
|........|........................| +------#-----+             #                                      
+---+....#........................###............|    +--------#-----------------+                    
|........|........................| |............|    |..........................|                    
+---#----+------------------------+ +---#--------+    |..........................+---+                
    #####   +----------------------+    ###############...........+-------+..........|                
        #####......................#####+------+      |...........|       |..........|        +------+
            |......................|   ##......########...........+-------+..........|        |......|
            |......................|    +------+  #   +---------------------#+.......##########......|
            |............+-----+...+--------------#-------------------------#+.......+---+    +------+
            |............|     |.........................................................|            
            |............|     |.........................................................|            
            +--+.........+-----+.........................................................|            
               |................................................................+--------+            
               |................................................................|                     
               +----------------#-------------------------------#---------------+                     
                              +-#------+                    +---#----+                                
                              |........|                    |........|                                
                           +--+........|                 +--+........|                                
                           |...........|                 |...........|                                
                           +-----------+                 +-----------+                                
